26 24
0 0 0 0 0 0 0 0 0 0 0 0 0 0 0 0 0 0 0 0 0 0 0 0 0 0
0 1 1 1 1 1 1 1 1 1 1 1 1 1 1 1 1 1 1 1 1 1 1 1 1 0
0 1 0 0 0 0 0 0 0 0 0 0 33 0 0 0 0 34 0 0 0 0 0 0 1 0
0 1 0 0 0 0 0 0 0 0 0 0 33 0 0 0 0 34 0 0 0 0 0 0 1 0
0 1 0 0 0 0 0 0 0 0 0 0 33 0 0 0 0 34 0 0 0 0 0 0 1 0
0 1 0 0 0 0 0 0 0 0 0 0 33 0 0 0 0 34 0 0 0 0 0 0 1 0
0 1 0 0 0 0 0 0 0 0 0 0 33 0 0 0 0 34 0 0 0 0 0 0 1 0
0 1 0 0 0 0 0 0 0 0 0 0 33 0 0 0 0 34 0 0 0 0 0 0 1 0
0 1 0 0 0 0 0 0 0 0 0 0 33 0 0 0 0 34 0 0 0 0 0 0 1 0
0 1 0 0 0 0 0 0 0 0 0 0 33 0 0 0 0 34 0 0 0 0 0 0 1 0
0 1 0 0 0 0 0 0 0 0 0 0 33 0 0 0 0 34 0 0 0 0 0 0 1 0
0 1 0 0 0 0 0 0 0 0 0 0 33 0 0 0 0 34 0 0 0 0 0 0 1 0
0 1 0 0 0 0 0 0 0 0 0 0 33 0 0 0 0 34 0 0 0 0 0 0 1 0
0 1 0 0 0 0 0 0 0 0 0 0 33 0 0 0 0 34 0 0 0 0 0 0 1 0
0 1 0 0 0 0 0 0 0 0 0 0 33 0 0 0 0 34 0 0 0 0 0 0 1 0
0 1 0 0 0 0 0 0 0 0 0 0 33 0 0 0 0 34 0 0 0 0 0 0 1 0
0 1 0 0 0 0 0 0 0 0 0 0 33 0 0 0 0 34 0 0 0 0 0 0 1 0
0 1 0 0 0 0 0 0 0 0 0 0 33 0 0 0 0 34 0 0 0 0 0 0 1 0
0 1 0 0 0 0 0 0 0 0 0 0 33 0 0 0 0 34 0 0 0 0 0 0 1 0
0 1 0 0 0 0 0 0 0 0 0 0 33 0 0 0 0 34 0 0 0 0 0 0 1 0
0 1 192 0 0 0 192 0 0 0 0 0 33 0 0 0 0 34 0 0 0 0 0 0 1 0
0 1 1 1 1 1 1 1 1 1 1 1 1 1 9 9 1 1 1 1 1 1 1 1 1 0
0 0 0 0 0 0 0 0 0 0 0 0 0 1 1 1 1 0 0 0 0 0 0 0 0 0
0 0 0 0 0 0 0 0 0 0 0 0 0 0 0 0 0 0 0 0 0 0 0 0 0 0
